
SO ./textures/debug_2/south.xpm

WE ./textures/debug_2/west.xpm

EA ./textures/debug_2/east.xpm

NO ./textures/debug_2/north.xpm

F 54,90,94
C 153,132,136

1111111
1011101
1101011
111N111
1101011
1011101
1111111
