
SO ./textures/south.xpm

WE ./textures/west.xpm

EA ./textures/east.xpm

NO ./textures/noth.xpm

F 202,206,199
C 128,188,218

111111111111
100000000001
100000000001
100000000001
100001100001
100001100001
100000000001
10000N000001
100000000001
100000000001
100000000001
111111111111
