
SO ./textures/texture_1.xpm

WE ./textures/texture_2.xpm

EA ./textures/texture_3.xpm

NO ./textures/texture_4.xpm

F 202,206,199
C 128,188,218

111111111111
100000000001
101000000001
100000000001
101000000001
100000000001
101000000001
10000N000001
101000000001
100000000001
100000000001
111111111111
