
SO ./path_to_the_south_texture

WE ./path_to_the_west_texture

EA ./path_to_the_east_texture

NO ./path_to_the_north_texture

F 54,90,94
C 153,132,136

111111111111
100000000001
100000000001
100000000001
111100011111
100000000001
100000000001
10000N000001
101000001001
101000001001
101000001001
111111111111
