
SO ./textures/debug/south.xpm

WE ./textures/debug/west.xpm

EA ./textures/debug/east.xpm

NO ./textures/debug/north.xpm

F 202,206,199
C 128,188,218

111111111111
100000000001
101000001101
101000000001
100000000001
100000000001
100000000001
100000000001
100000000001
100000000001
100000000001
100000000001
100000000001
100000000001
100000000001
100000000001
10000E000001
100000000101
101100000101
100000000001
111111111111
