
SO ./path_to_the_south_texture

WE ./path_to_the_west_texture

EA       ./path_to_the_east_texture

NO ./path_to_the_north_texture

F 54,90,94
C 153,132,136

11111
100001
100001
100S01
101101
11111
