
SO ./path_to_the_south_texture

WE ./path_to_the_west_texture

EA ./path_to_the_east_texture

NO ./path_to_the_north_texture

F 54,90,94
C 153,132,136

1111111
10100001
10100001
10000001
10000001
10000101
100000N1
1111111
