
SO ./path_to_the_south_texture

WE ./path_to_the_west_texture

EA ./path_to_the_east_texture

NO ./path_to_the_north_texture

F 54,90,94
C 153,132,136

111111111111
100000000001
10100N000101
100000000001
100011110001
100010010001
100010010001
100011110001
100000000001
101000000101
100000000001
111111111111
