
SO ./textures/tex_2/south.xpm

WE ./textures/tex_2/west.xpm

EA ./textures/tex_2/east.xpm

NO ./textures/tex_2/north.xpm

F 202,206,199
C 128,188,218

11111111111111111111111111111111111
10000D0000000000000000000000W100001
10011100000000000000001111111100001
10011100000000000000001000001000001
1001110000000000000000D00000D000001
10000D00000000000000001000001000001
11111111100000000000001111111111D11
        100000000000001000000000001
        10000000000000D000000000001
11111111000000000000001110000000011
1111111111000000110000011111111111
          111D11111D1111
          10000011000001
          10000011000001
          10000011000001
          10000011000001
1111111111111D111111D111
100000000010000000000001111111
1000000000D000000000001000001
1000000000111110000000D0000001
100000000011111111100010000001
1000000011000101001DD110000001
100000001100010100100110000001
11111111111D11D1D1100110000001
111111111110110100100110000001
111111111110110110100110000001
111111111110110100100110000001
111111000000110101100110000001
111111000000000000000000000001
1111111111D11111111D111111D111
111000000000000000000000000111
11000000000001D100000000000011
100000000000010100000000000001
110000000000011100000000000011
111000000000000000000000000111
111111111111111111111111111111
