
SO ./path_to_the_south_texture

WE ./path_to_the_west_texture

EA       ./path_to_the_east_texture

NO ./path_to_the_north_texture

F 54,90,94
C 153,132,136

111111111111111111111111111111
1000000000000000000000000000W1
100111000000000000000011111111
10011100000000000000001
10011100000000000000001
10000000000000000000001
11111111100000000000001
        100000000000001
        100000000000001
111111110000000000000001
111111111100000011000001
          10000011000001
          10000011000001
          10000011000001
          10000011000001
          10000011000001
111111111110000000000001
100000000000000000000001111111
100000000000000000000000000001
100000000011111000000000000001
100000000011111111100000000001
100000001100010100100110000001
100000001100010100100110000001
111111111110110101100110000001
111111111110110100100110000001
111111111110110110100110000001
111111111110110100100110000001
111111000000110101100110000001
111111000000000000000000000001
111100000000000000000000000001
111111111111111111111111111111
