
SO ./textures/tex_1/south.xpm

WE ./textures/tex_1/west.xpm

EA ./textures/tex_1/east.xpm

NO ./textures/tex_1/north.xpm

F 54,90,94
C 153,132,136

111111111111111111111111111111
10000D0000000000000000000000W1
100111000000000000000011111111
10011100000000000000001000001
1001110000000000000000D000001
10000D00000000000000001000001
11111111100000000000001111111
        100000000000001
        100000000000001
111111110000000000000001
111111111100000011000001
          111D11111D1111
          10000011000001
          10000011000001
          10000011000001
          10000011000001
1111111111111D111111D111
100000000010000000000001111111
1000000000D000000000001000001
1000000000111110000000D0000001
100000000011111111100010000001
1000000011000101001DD110000001
100000001100010100100110000001
111111111110110101100110000001
111111111110110100100110000001
111111111110110110100110000001
111111111110110100100110000001
111111000000110101100110000001
111111000000000000000000000001
111100000000000000000000000001
111111111111111111111111111111
